10 10
##########
..........
##########
##########
..........
#.#.#.#.#.
.#.#.#.#.#
#.#.#.#.#.
.#.#.#.#.#
..........